default_graphic
12
13
3	4	4	4	4	4	4	4	4	4	4	4	4	4	4	4	4	4	2
5	0	0	0	0	0	0	0	0	0	0	0	0	0	0	0	0	0	5
5	0	1	0	1	0	1	0	1	0	1	0	1	0	1	0	1	0	5
5	0	0	0	0	0	0	0	0	0	0	0	0	0	0	0	0	0	5
5	0	1	0	1	0	1	0	1	0	1	0	1	0	1	0	1	0	5
5	0	0	0	0	0	0	0	0	0	0	0	0	0	0	0	0	0	5
5	0	1	0	1	0	1	0	1	0	1	0	1	0	1	0	1	0	5
5	0	0	0	0	0	0	0	0	0	0	0	0	0	0	0	0	0	5
5	0	1	0	1	0	1	0	1	0	1	0	1	0	1	0	1	0	5
5	0	0	0	0	0	0	0	0	0	0	0	0	0	0	0	0	0	5
5	0	1	0	1	0	1	0	1	0	1	0	1	0	1	0	1	0	5
5	0	0	0	0	0	0	0	0	0	0	0	0	0	0	0	0	0	5
7	4	4	4	4	4	4	4	4	4	4	4	4	4	4	4	4	4	6
3,1;4,1;5,1;6,1;7,1;8,1;9,1;10,1;11,1;12,1;13,1;14,1;15,1;3,2;5,2;7,2;9,2;11,2;13,2;15,2;1,3;2,3;3,3;4,3;5,3;6,3;7,3;8,3;9,3;10,3;11,3;12,3;13,3;14,3;15,3;16,3;17,3;1,4;3,4;5,4;7,4;9,4;11,4;13,4;15,4;17,4;1,5;2,5;3,5;4,5;5,5;6,5;7,5;8,5;9,5;10,5;11,5;12,5;13,5;14,5;15,5;16,5;17,5;1,6;3,6;5,6;7,6;9,6;11,6;13,6;15,6;17,6;1,7;2,7;3,7;4,7;5,7;6,7;7,7;8,7;9,7;10,7;11,7;12,7;13,7;14,7;15,7;16,7;17,7;1,8;3,8;5,8;7,8;9,8;11,8;13,8;15,8;17,8;1,9;2,9;3,9;4,9;5,9;6,9;7,9;8,9;9,9;10,9;11,9;12,9;13,9;14,9;15,9;16,9;17,9;3,10;5,10;7,10;9,10;11,10;13,10;15,10;3,11;4,11;5,11;6,11;7,11;8,11;9,11;10,11;11,11;12,11;13,11;14,11;15,11
